###########
#....R....#
#.*******.#
#.\\\\\\\.#
#.       .#
#..*\\\*..#
#.#*\\\*#.#
#########L#
